مکان‌های تاریخی:

آرامستان تاریخی مسیحیان دولاب: مدفن اقلیت‌های مذهبی، سنگ‌قبرها با خطوط ارمنی و لاتین، معماری گورستان‌های تاریخی

عمارت تاریخی کلاه فرنگی عشرت آباد: کلاه فرنگی، دوره قاجار، معماری اروپایی

کودکستان تاریخی برسابه: کاربری آموزشی، دوره پهلوی، معماری مدرن

عمارت سرهنگ ایرج (خانه تاریخی پامنار): معماری مسکونی، دوره قاجار، خانه صاحب منصب

برجک تاریخی زندان قصر: برج دیده‌بانی، زندان سیاسی، دوره پهلوی

عمارت امین السلطان (خانه تاریخی اتحادیه): معماری قاجاری، خانه رجال سیاسی، تزئینات گچبری

بازارچه تاریخی عودلاجان: راسته‌های بازار، معماری سنتی، بافت تاریخی

عمارت تاریخی امام جمعه: معماری مذهبی، دوره صفویه، اقامتگاه روحانی

مدرسه تاریخی دارالفنون: آموزش نوین، دوره قاجار، معماری ترکیبی

خانه تاریخی ملک: خانه بازرگان، دوره قاجار، هنر ایرانی

عمارت تاریخی کوچه هفت تن: خانه اعیانی، دوره قاجار، کوچه‌های تاریخی

سرای باستانی: اقامتگاه مسافرین، دوره تاریخی نامشخص، معماری کاروانسرا

عمارت و باغ تاریخی اعلم السلطنه: باغ ایرانی، دوره قاجار، خانه اشراف

خانه تاریخی مستوفی الممالک: خانه رجال سیاسی، دوره قاجار، معماری ایرانی

خانه باستان شناسان ایران: اقامتگاه علمی، دوره پهلوی، خانه متخصصان

باغ عمارت تاریخی معیرالممالک کیهانی: باغ ایرانی، دوره قاجار، معماری کاخ

بازارچه تاریخی نایب آقا: راسته‌های بازار، دوره قاجار، معماری سنتی

آتش کده تاریخی به سمت کوه راگا: عبادتگاه زرتشتیان، دوره تاریخی نامشخص، آتش مقدس

قلعه باستانی عظیم آباد: قلعه نظامی، دوره تاریخی نامشخص، دیوارهای دفاعی

خانه تاریخی علامه کرباسچیان: خانه عالم دینی، دوره پهلوی، معماری ایرانی

عمارت تاریخی خسروشاهی: خانه بازرگان، دوره قاجار، معماری ایرانی

حمام تاریخی کن: حمام عمومی، دوره قاجار، معماری سنتی

پل تاریخی کن: پل عبوری، دوره صفویه، معماری پل سازی

مجموعه فرهنگی تاریخی کاخ نیاوران: مجموعه کاخ‌ها، دوره پهلوی، اقامتگاه سلطنتی

موزه ملی ایران باستان: موزه باستان‌شناسی، دوره پهلوی، آثار باستانی ایران

باغ و عمارت فخر الدوله: باغ ایرانی، دوره قاجار، خانه رجال

خانه مداحان اهل بیت (ع): محفل مذهبی، دوره معاصر، خانه هنرمندان

دفتر قدیمی مجله صبح امروز و ماهنامه دانشمند: محل انتشار نشریات، دوره پهلوی، دفتر روزنامه نگاری

خانه فراغت (عمارت دبیرالملک): خانه اعیانی، دوره قاجار، معماری ایرانی

خانه قوام الدوله: خانه رجال سیاسی، دوره قاجار، معماری ایرانی

خانه همسایه: خانه تاریخی، دوره قاجار، معماری مسکونی

خانه اردیبهشت‌ عودلاجان: خانه تاریخی، دوره قاجار، معماری سنتی

خانه موتمن الاطبا: خانه طبیب، دوره قاجار، معماری ایرانی

خانه لشگر نویس: خانه ادیب، دوره قاجار، معماری ایرانی

خانه موزه بازار (عمارت سلطان بیگم): خانه اشراف، دوره قاجار، معماری ایرانی

عمارت سرهنگ بهرامی: خانه صاحب منصب، دوره پهلوی، معماری مدرن

عمارت کوشک: کوشک، دوره قاجار، معماری کاخ

خانه خسرو افشار - ستاد سمن های شهر تهران: خانه فعال اجتماعی، دوره پهلوی، محل گردهمایی

عمارت شقاقی - کوشک مصری: معماری تلفیقی، دوره پهلوی، کوشک

آتشکده زرتشتیان آدریان: عبادتگاه زرتشتیان، دوره معاصر، آتش مقدس

موزه خودروهای تاریخی ایران: موزه اتومبیل، دوره معاصر، خودروهای قدیمی

کاخ خرم (کاخ سنگی): کاخ سلطنتی، دوره پهلوی، معماری مدرن

خانه پروفسور یحیی عدل: خانه حقوقدان، دوره پهلوی، معماری مدرن

برجک قلعه شمس آباد: برج دیده‌بانی، دوره تاریخی نامشخص، قلعه نظامی

آسیاب آبی یوسف آباد: آسیاب آبی، دوره قاجار، تکنولوژی سنتی

حمام انصاری: حمام عمومی، دوره قاجار، معماری سنتی

برج تاریخی طغرل: برج آرامگاهی، دوره سلجوقی، معماری سلجوقی

قلعه تاریخی کاسنی: قلعه نظامی، دوره تاریخی نامشخص، دیوارهای دفاعی

باغ ظهیرالدوله: باغ ایرانی، دوره قاجار، آرامگاه مشاهیر

باروی ری: دیوار دفاعی، دوره تاریخی نامشخص، حصار شهر

سنگ نگاره فتحعلی شاه شهرری: کتیبه تاریخی، دوره قاجار، سنگ نگاره

ارگ سلجوقی ری: ارگ حکومتی، دوره سلجوقی، معماری سلجوقی

دژ رشکان: قلعه نظامی، دوره تاریخی نامشخص، دیوارهای دفاعی

قلعه ظهیرآباد: قلعه نظامی، دوره تاریخی نامشخص، دیوارهای دفاعی

کاروانسرای صفوی (عباسی): اقامتگاه مسافرین، دوره صفویه، معماری کاروانسرا

کاروانسرای دوقلو قاجاری: اقامتگاه مسافرین، دوره قاجار، معماری کاروانسرا

ساعت آفتابی: ابزار نجومی، دوره تاریخی نامشخص، اندازه‌گیری زمان

قلعه گبری شهر ری: قلعه نظامی، دوره تاریخی نامشخص، دیوارهای دفاعی

محله هفت دستگاه: بافت مسکونی، دوره پهلوی، معماری مدرن

برج نقاره خانه (برج یزید ری): برج تاریخی، دوره تاریخی نامشخص، کاربرد نامشخص

برج اینانج: برج تاریخی، دوره تاریخی نامشخص، کاربرد نامشخص

قلعه علیمون: قلعه نظامی، دوره تاریخی نامشخص، دیوارهای دفاعی

موزه‌ها:

باغ موزه هنر ایرانی: هنرهای تجسمی، فضای باز، دوره معاصر

موزه سینمای ایران: تاریخ سینما، تجهیزات سینمایی، دوره معاصر

موزه دکتر حسابی: فیزیکدان، وسایل شخصی، دوره معاصر

موزه موسیقی تهران: سازهای موسیقی، تاریخ موسیقی، دوره معاصر

موزه زمان: ساعت، گاهشماری، دوره معاصر

بنیادفرهنگی امیر کبیر موزه خانه دکتر حبیبی: تاریخ معاصر، شخصیت‌های سیاسی، دوره معاصر

موزه هنرهای زیبا: هنرهای تجسمی، آثار هنری، دوره معاصر

کاخ موزه ملت (کاخ سفید): اقامتگاه سلطنتی، معماری پهلوی، دوره پهلوی

خانه موزه سیمین دانشور و جلال آل احمد: نویسندگان، زندگی شخصی، دوره معاصر

موزه اتومبیل های سلطنتی: خودروهای لوکس، دوره پهلوی، خودروهای سلطنتی

خانه نیما یوشیج (تهران): شاعر، زندگی شخصی، دوره معاصر

موزه آشپزخانه سلطنتی: فرهنگ غذایی، تجهیزات آشپزخانه، دوره قاجار و پهلوی

موزه خط و کتابت میرعماد: خوشنویسی، آثار خطاطی، دوره معاصر

موزه استاد فرشچیان: مینیاتور، نگارگری، دوره معاصر

مجموعه فرهنگی تا‌‌‌‌ریخی کاخ سعدآباد: مجموعه کاخ‌ها، دوره پهلوی، اقامتگاه سلطنتی

موزه استاد حسین بهزاد: مینیاتور، نگارگری، دوره معاصر

خانه موزه عزت الله انتظامی: بازیگر، زندگی شخصی، دوره معاصر

مدل هیدرولیکی بند امیر: مدل سد، مهندسی آب، دوره معاصر

مدل هیدرولیکی سد کارون 3: مدل سد، مهندسی آب، دوره معاصر

موزه نیروی هوایی: هواپیما، تاریخ هوانوردی، دوره معاصر

موزه نظامی: سلاح، تاریخ نظامی، دوره معاصر

موزه آب: منابع آب، تکنولوژی آب، دوره معاصر

کاخ اشرف (موزه ظروف سلطنتی): ظروف سلطنتی، دوره پهلوی، ظروف لوکس

کاخ موزه سبز (کاخ شهوند): اقامتگاه سلطنتی، معماری پهلوی، دوره پهلوی

کاخ شمس (موزه پوشاک سلطنتی): پوشاک سلطنتی، دوره پهلوی، مد و لباس

موزه برادران امیدوار: سفرنامه، جهانگردی، دوره معاصر

کاخ کوشک احمدشاهی: اقامتگاه سلطنتی، دوره قاجار، معماری کاخ

آرت سنتر باغ: هنرهای تجسمی، فضای باز، دوره معاصر

موزه سلاح های دربار: سلاح، دوره قاجار و پهلوی، سلاح‌های سلطنتی

نگارخانه سعدآباد: هنرهای تجسمی، دوره معاصر، نمایشگاه هنری

موزه کامپیوتر ایران: تاریخ کامپیوتر، تکنولوژی، دوره معاصر

موزه مجازی هنر کودک: هنر کودک، فضای مجازی، دوره معاصر

موزه فرش رسام عرب زاده: فرش، هنر قالیبافی، دوره معاصر

موزه موسسه فرهنگی هنری رسام عرب زاده: هنرهای تجسمی، دوره معاصر، نمایشگاه هنری

موزه آموزشی سروش: آموزش و پرورش، دوره معاصر، وسایل آموزشی

موزه رضا عباسی: هنرهای تجسمی، دوره معاصر، آثار هنری

زندان سیاسی شماره 2: زندان سیاسی، دوره پهلوی، تاریخ معاصر

باغ موزه زندان قصر: زندان سیاسی، دوره پهلوی، فضای باز

موزه ملی کارآفرینان ایرانی: کارآفرینی، دوره معاصر، چهره‌های موفق

موزه کودکی ایرانک: کودکی، بازی و سرگرمی، دوره معاصر

ساختمان گنجینه اسناد ملی (آرشیو ملی ایران): اسناد تاریخی، دوره معاصر، آرشیو ملی

باغ موزه ملی کار: تاریخ کار، فضای باز، دوره معاصر

موزه نیروی هوایی ارتش: هواپیما، تاریخ هوانوردی، دوره معاصر

عمارت ارباب هرمز (موزه گرافیک ایران): گرافیک، هنرهای تجسمی، دوره معاصر

موزه نسخ خطی کتابخانه ملی: نسخ خطی، کتاب‌های قدیمی، دوره تاریخی

موزه کتاب و میراث مستند ایران: کتاب، اسناد تاریخی، دوره معاصر

پارک موزه آب: منابع آب، فضای باز، دوره معاصر

باغ موزه اب: منابع آب، فضای باز، دوره معاصر

موزه ملی علوم و فناوری: علوم و فناوری، دوره معاصر، نمایشگاه علمی

موزه سرای شهید آیت الله دکتر بهشتی: شخصیت سیاسی، دوره معاصر، زندگی شخصی

نگارخانه نهاوند: هنرهای تجسمی، دوره معاصر، نمایشگاه هنری

خانه موزه شهید مطهری: عالم دینی، دوره معاصر، زندگی شخصی

قصر فیروزه (کاخ فرح‌آباد): کاخ سلطنتی، دوره پهلوی، معماری مدرن

باغ موزه بانک مرکزی ایران: تاریخ بانکداری، فضای باز، دوره معاصر

موزه سراسرنمای دفاع مقدس: جنگ ایران و عراق، دوره معاصر، پانوراما

باغ موزه دفاع مقدس: جنگ ایران و عراق، فضای باز، دوره معاصر

موزه نقشه تهران: تاریخ تهران، نقشه‌های قدیمی، دوره معاصر

خانه موزه استاد لر زاده: موسیقیدان، زندگی شخصی، دوره معاصر

موزه عکاس خانه شهر: عکاسی، دوره معاصر، عکس‌های قدیمی

موزه آثار شهدا: شهدای انقلاب، دوره معاصر، یادبود شهدا

خانه و موزه استاد معین و استاد امیر جاهد: موسیقیدان، زندگی شخصی، دوره معاصر

موزه صنعت برق ایران: تاریخ برق، تکنولوژی، دوره معاصر

مرکز هنر پردیس - سنگسر: هنرهای تجسمی، دوره معاصر، نمایشگاه هنری

خانه موزه شهید رجایی: شخصیت سیاسی، دوره معاصر، زندگی شخصی

باغ موزه نگارستان: هنرهای تجسمی، فضای باز، دوره قاجار

مجلس قدیم: تاریخ مجلس، دوره قاجار و پهلوی، معماری ایرانی

موزه هنرهای تجسمی پاسارگاد: هنرهای تجسمی، دوره معاصر، نمایشگاه هنری

موزه تاریخ مفاخر باغ نگارستان: چهره‌های ماندگار، دوره معاصر، یادبود مشاهیر

موزه هنرهای ملی: هنرهای سنتی، دوره معاصر، صنایع دستی

حمام نواب: حمام عمومی، دوره قاجار، معماری سنتی

خانه موزه شهید مدرس: سیاستمدار، دوره پهلوی، زندگی شخصی

موزه خوشنویسی: خطاطی، آثار خطاطی، دوره معاصر

خانه موزه استاد ابوالحسن صبا: موسیقیدان، دوره معاصر، زندگی شخصی

موزه نقاشی پشت شیشه: هنر نقاشی، دوره قاجار، هنرهای سنتی

موزه عمارت کاظمی: عمارت تاریخی، دوره قاجار، معماری ایرانی

موزه حمام قبله (حمام خانم): حمام عمومی، دوره قاجار، معماری سنتی

موزه پمپ بنزین دروازه دولت: تاریخ تهران، دوره پهلوی، معماری مدرن

موزه عروسک و فرهنگ: عروسک، فرهنگ عامه، دوره معاصر

خانه موزه شهید دکتر چمران: شخصیت سیاسی، دوره معاصر، زندگی شخصی

موزه و مجتمع فرهنگی 13 آبان: تاریخ انقلاب، دوره معاصر، یادبود شهدا

خانه ابتهاج: شاعر، دوره معاصر، زندگی شخصی

موزه جواهرات ملی: جواهرات سلطنتی، دوره قاجار و پهلوی، جواهرات قیمتی

موزه بانک ملی ایران: تاریخ بانکداری، دوره معاصر، اسناد بانکی

موزه استاد علی اکبر صنعتی: نقاشی قهوه‌خانه‌ای، دوره معاصر، هنرهای سنتی

موزه سکه بانک سپه: سکه، تاریخ سکه، دوره تاریخی

کاخ برلیان: کاخ سلطنتی، دوره پهلوی، معماری مدرن

شمس العماره: کاخ سلطنتی، دوره قاجار، معماری کاخ

تالار ظروف: ظروف سلطنتی، دوره قاجار، ظروف لوکس

موزه حوضخانه: حوضخانه سنتی، دوره قاجار، معماری ایرانی

عمارت بادگیر: معماری سنتی، دوره قاجار، بادگیر

کاخ موزه گلستان: مجموعه کاخ‌ها، دوره قاجار، اقامتگاه سلطنتی

تالار سلام: تالار تشریفاتی، دوره قاجار، معماری ایرانی

عمارت چادرخانه و عکسخانه: عمارت تاریخی، دوره قاجار، معماری ایرانی

موزه عبرت: زندان سیاسی، دوره پهلوی، تاریخ معاصر

خلوت کریم خانی: عمارت تاریخی، دوره قاجار، معماری ایرانی

موزه ارتباطات: تاریخ ارتباطات، دوره معاصر، تکنولوژی ارتباطات

موزه مخصوص: اسناد تاریخی، دوره پهلوی، آرشیو سلطنتی

موزه مردم شناسی (کاخ ابیض): فرهنگ عامه، دوره پهلوی، آداب و رسوم

موزه عكسخانه: عکاسی، دوره قاجار، عکس‌های قدیمی

موزه نگارخانه: هنرهای تجسمی، دوره معاصر، نمایشگاه هنری

موزه گمرک ایران: تاریخ گمرک، دوره معاصر، اسناد گمرکی

موزه کتاب آرایی ملک: هنر کتاب آرایی، دوره معاصر، کتاب‌های نفیس

خانه موزه مهدی اخوان ثالث: شاعر، دوره معاصر، زندگی شخصی

موزه سیار خلاقیت کودک و نوجوان: خلاقیت، دوره معاصر، کارگاه آموزشی

خانه موزه چمن آرا (بتهوون): موسیقیدان، دوره معاصر، زندگی شخصی

موزه ملی هنر و ادبیات کودک: هنر کودک، ادبیات کودک، دوره معاصر

موزه علوم و فناوری: علوم و فناوری، دوره معاصر، نمایشگاه علمی

موزه فرش ایران: فرش، هنر قالیبافی، دوره معاصر

موزه تصاویر معاصر: عکاسی، دوره معاصر، عکس‌های قدیمی

موزه خیمه شب بازی: خیمه شب بازی، دوره معاصر، فرهنگ عامه

موزه ماشین های اداری سفیر: تاریخ تکنولوژی، دوره معاصر، ماشین‌های اداری

موزه هنرهای معاصر تهران: هنرهای معاصر، دوره معاصر، آثار هنری

موزه هنرهای معاصر فلسطین: هنر فلسطینی، دوره معاصر، هنر مقاومت

موزه جانور شناسی: جانورشناسی، دوره معاصر، حیوانات تاکسیدرمی

موزه تاریخ علوم پزشکی: تاریخ پزشکی، دوره معاصر، ابزار پزشکی

خانه موزه دکتر شریعتی: نویسنده، دوره معاصر، زندگی شخصی

موزه تمبرهای طلا و نقره ایران: تمبر، دوره معاصر، تمبرهای قیمتی

موزه شهدا: شهدای انقلاب، دوره معاصر، یادبود شهدا

خانه موزه دکتر سندوزی: پزشک، دوره معاصر، زندگی شخصی

خانه موزه هایده چنگیزیان: خواننده، دوره معاصر، زندگی شخصی

موزه اسباب بازی: اسباب بازی، دوره معاصر، بازی و سرگرمی

خانه استاد حسین بهزاد: مینیاتور، دوره معاصر، زندگی شخصی

موزه مردم شناسی ارامنه (موزه اسقف اعظم آرداک مانوکیان): فرهنگ ارامنه، دوره معاصر، آداب و رسوم

موزه علوم و فنون جمهوری اسلامی ایران: علوم و فناوری، دوره معاصر، نمایشگاه علمی

موزه آبگینه و سفالینه های ایران (خانه قوام السلطنه): شیشه و سفال، دوره تاریخی، ظروف قدیمی

موزه و نمایشگاه هوایی: هواپیما، دوره معاصر، نمایشگاه هوایی

موزه علوم زمین: زمین شناسی، دوره معاصر، نمونه‌های زمین شناسی

موزه آشور ارومیه: باستان شناسی، دوره آشوری، آثار باستانی

موزه برج آزادی (تالار کهن): تاریخ تهران، دوره معاصر، معماری مدرن

خانه موزه شهید مهدی پور: شهید انقلاب، دوره معاصر، زندگی شخصی

موزه دانشگاه علامه طباطبائی: تاریخ دانشگاه، دوره معاصر، اسناد دانشگاهی

موزه شهیدان اقبالی: شهدای انقلاب، دوره معاصر، یادبود شهدا

موزه حیات وحش پردیسان: حیات وحش، دوره معاصر، حیوانات تاکسیدرمی

موزه تنوع زیستی: تنوع زیستی، دوره معاصر، نمونه‌های طبیعی

موزه ملی آب: منابع آب، دوره معاصر، تکنولوژی آب

موزه خودروهای تاریخی ایران: خودروهای قدیمی، دوره معاصر، تاریخچه خودرو

موزه مبل: مبل، دوره معاصر، تاریخچه مبل

موزه شهرداری برج میلاد: تاریخ شهرداری، دوره معاصر، اسناد شهرداری

موزه مشاهیر برج میلاد: چهره‌های ماندگار، دوره معاصر، یادبود مشاهیر

موزه حیات وحش و آثار طبیعی هفت چنار: حیات وحش، دوره معاصر، حیوانات تاکسیدرمی

خانه تیمورتاش (موزه دانشگاه جنگ): تاریخ نظامی، دوره پهلوی، زندگی شخصی

کاخ تیمورتاش: کاخ سلطنتی، دوره پهلوی، معماری مدرن

خانه موزه شهیدان کربلایی: شهدای انقلاب، دوره معاصر، یادبود شهدا

نمایشگاه موشکی نیروی هوا فضا سپاه: موشک، دوره معاصر، تجهیزات نظامی

موزه عبدالعظیم حسنی: شخصیت مذهبی، دوره تاریخی، زندگی شخصی

موزه‌ها و مرکز اسناد صنعت نفت: تاریخ نفت، دوره معاصر، اسناد نفتی

موزه عمارت انیس الدوله: عمارت تاریخی، دوره قاجار، معماری ایرانی

موزه شهید قدمی: شهید انقلاب، دوره معاصر، زندگی شخصی

موزه مفاخر: چهره‌های ماندگار، دوره معاصر، یادبود مشاهیر

موزه دخانیات ایران: تاریخ دخانیات، دوره معاصر، ابزار دخانیات

موزه تاریخ روانپزشکی روزبه: تاریخ روانپزشکی، دوره معاصر، ابزار پزشکی