لیست مکان های تاریخی:

آرامستان تاریخی مسیحیان دولاب: دوره قاجار، آرامستان مسیحی، معماری گوتیک، دولاب، مقبره تاریخی

عمارت تاریخی کلاه فرنگی عشرت آباد: دوره قاجار، معماری کلاه فرنگی، عشرت آباد، عمارت اعیانی، باغ تاریخی

کودکستان تاریخی برسابه: دوره پهلوی، معماری مدرن اولیه، برسابه، فضای آموزشی تاریخی، ساختمان تاریخی

عمارت سرهنگ ایرج (خانه تاریخی پامنار): دوره پهلوی، معماری ایرانی، پامنار، خانه اعیانی، معماری مدرن

برجک تاریخی زندان قصر: دوره پهلوی، زندان سیاسی، معماری نظامی، برج نگهبانی، یادمان تاریخی

عمارت امین السلطان (خانه تاریخی اتحادیه): دوره قاجار، معماری سنتی، خانه اعیانی، اتحادیه، معماری ایرانی

بازارچه تاریخی عودلاجان: دوره قاجار، بازار سنتی، عودلاجان، تجارت تاریخی، معماری سنتی

عمارت تاریخی امام جمعه: دوره قاجار، معماری سنتی، خانه اعیانی، امام جمعه، معماری ایرانی

مدرسه تاریخی دارالفنون: دوره قاجار، مدرسه مدرن، دارالفنون، آموزش نوین، معماری کلاسیک

خانه تاریخی ملک: دوره پهلوی، معماری سنتی، خانه اعیانی، ملک، معماری ایرانی

عمارت تاریخی کوچه هفت تن: دوره قاجار، کوچه هفت تن، معماری سنتی، خانه اعیانی، معماری ایرانی

سرای باستانی: دوره قبل از اسلام، سرای تجاری، معماری سنتی، کاروانسرا، بافت تاریخی

عمارت و باغ تاریخی اعلم السلطنه: دوره قاجار، باغ ایرانی، عمارت اعیانی، اعلم السلطنه، معماری سنتی

خانه تاریخی مستوفی الممالک: دوره قاجار، معماری سنتی، خانه اعیانی، مستوفی الممالک، معماری ایرانی

خانه باستان شناسان ایران: دوره معاصر، باستان شناسی، معماری مدرن، مرکز پژوهشی، حوزه مطالعاتی

باغ عمارت تاریخی معیرالممالک کیهانی: دوره قاجار، باغ ایرانی، عمارت اعیانی، معیرالممالک، معماری سنتی

بازارچه تاریخی نایب آقا: دوره قاجار، بازار سنتی، نایب آقا، تجارت تاریخی، معماری سنتی

اتش کده تاریخی به سمت کوه راگا: دوره ساسانی، آتشکده زرتشتی، معماری مذهبی، راگا، دوره ساسانی

قلعه باستانی عظیم آباد: دوره قبل از اسلام، قلعه نظامی، معماری دفاعی، عظیم آباد، بافت تاریخی

خانه تاریخی علامه کرباسچیان: دوره پهلوی، معماری سنتی، خانه اعیانی، علامه کرباسچیان، معماری ایرانی

عمارت تاریخی خسروشاهی: دوره قاجار، معماری سنتی، خانه اعیانی، خسروشاهی، معماری ایرانی

حمام تاریخی کن: دوره قاجار، حمام سنتی، کن، معماری سنتی، فضاهای شهری

پل تاریخی کن: دوره قاجار، پل تاریخی، کن، معماری پل سازی، فضاهای شهری

مجموعه فرهنگی تاریخی کاخ نیاوران: دوره پهلوی، کاخ سلطنتی، نیاوران، معماری سلطنتی، کاخ پهلوی

موزه ملی ایران باستان: دوره های مختلف، باستان شناسی ایران، آثار باستانی، تاریخ باستان، فرهنگ باستانی

باغ و عمارت فخر الدوله: دوره قاجار، باغ ایرانی، عمارت اعیانی، فخر الدوله، معماری سنتی

خانه مداحان اهل بیت (ع): دوره معاصر، مداحی، معماری سنتی، خانه مذهبی، فرهنگ مذهبی

دفتر قدیمی مجله صبح امروز و ماهنامه دانشمند: دوره پهلوی، مطبوعات، تاریخ مطبوعات، معماری سنتی، ادبیات

خانه فراغت (عمارت دبیرالملک): دوره قاجار، معماری سنتی، خانه اعیانی، دبیرالملک، معماری ایرانی

خانه قوام الدوله: دوره قاجار، معماری سنتی، خانه اعیانی، قوام الدوله، معماری ایرانی

خانه همسایه: دوره پهلوی، معماری سنتی، خانه مسکونی، معماری ایرانی، زندگی شهری

خانه اردیبهشت‌ عودلاجان: دوره قاجار، معماری سنتی، خانه اعیانی، عودلاجان، معماری ایرانی

خانه موتمن الاطبا: دوره قاجار، معماری سنتی، خانه اعیانی، موتمن الاطبا، معماری ایرانی

خانه لشگر نویس: دوره قاجار، معماری سنتی، خانه اعیانی، لشگر نویس، معماری ایرانی

خانه موزه بازار (عمارت سلطان بیگم): دوره قاجار، معماری سنتی، خانه اعیانی، سلطان بیگم، معماری ایرانی

عمارت سرهنگ بهرامی: دوره پهلوی، معماری سنتی، خانه اعیانی، سرهنگ بهرامی، معماری ایرانی

عمارت کوشک: دوره قاجار، معماری سنتی، خانه اعیانی، کوشک، معماری ایرانی

خانه خسرو افشار - ستاد سمن های شهر تهران: دوره پهلوی، معماری سنتی، خانه اعیانی، خسرو افشار، معماری ایرانی

عمارت شقاقی - کوشک مصری: دوره پهلوی، معماری مدرن، کوشک مصری، عمارت اعیانی، معماری ایرانی

آتشکده زرتشتیان آدریان: دوره ساسانی، آتشکده زرتشتی، معماری مذهبی، آدریان، دوره ساسانی

موزه خودروهای تاریخی ایران: دوره پهلوی و قبل، خودروهای تاریخی، تاریخ صنعت خودرو، ماشین های کلاسیک، وسایل نقلیه تاریخی

کاخ خرم (کاخ سنگی): دوره پهلوی، کاخ سلطنتی، معماری مدرن، کاخ پهلوی، معماری سنگی

خانه پروفسور یحیی عدل: دوره پهلوی، معماری سنتی، خانه اعیانی، پروفسور عدل، معماری ایرانی

برجک قلعه شمس آباد: دوره قاجار، قلعه نظامی، برج نگهبانی، شمس آباد، معماری نظامی

آسیاب آبی یوسف آباد: دوره قاجار، آسیاب آبی، یوسف آباد، معماری سنتی، فناوری سنتی

حمام انصاری: دوره قاجار، حمام سنتی، معماری سنتی، حمام عمومی، فضاهای شهری

برج تاریخی طغرل: دوره سلجوقی، برج تاریخی، طغرل، معماری نظامی، دوره سلجوقی

قلعه تاریخی کاسنی: دوره قاجار، قلعه نظامی، کاسنی، معماری نظامی، دفاعی

باغ ظهیرالدوله: دوره قاجار، باغ ایرانی، ظهیرالدوله، معماری سنتی، باغ اعیانی

باروی ری: دوره های مختلف، دیوار دفاعی، ری، معماری دفاعی، بافت تاریخی

سنگ نگاره فتحعلی شاه شهرری: دوره قاجار، سنگ نگاره، فتحعلی شاه، شهرری، نقاشی سنگی

ارگ سلجوقی ری: دوره سلجوقی، ارگ سلطنتی، ری، معماری سلطنتی، دوره سلجوقی

دژ رشکان: دوره ساسانی، دژ نظامی، رشکان، معماری دفاعی، دوره ساسانی

قلعه ظهیرآباد: دوره قاجار، قلعه نظامی، ظهیرآباد، معماری نظامی، دفاعی

کاروانسرای صفوی (عباسی): دوره صفوی، کاروانسرا، معماری سنتی، راه ابریشم، دوره صفوی

کاروانسرای دوقلو قاجاری: دوره قاجار، کاروانسرا، معماری سنتی، راه ابریشم، دوره قاجار

ساعت آفتابی: دوره قاجار، ساعت آفتابی، معماری سنتی، ابزار نجومی، دوره قاجار

قلعه گبری شهر ری: دوره قبل از اسلام، قلعه نظامی، ری، معماری دفاعی، بافت تاریخی

محله هفت دستگاه: دوره قاجار، محله تاریخی، معماری سنتی، بافت تاریخی، زندگی شهری

برج نقاره خانه (برج یزید ری): دوره ایلخانی، برج تاریخی، ری، معماری اسلامی، دوره ایلخانی

برج اینانج: دوره سلجوقی، برج تاریخی، اینانج، معماری نظامی، دوره سلجوقی

قلعه علیمون: دوره قاجار، قلعه نظامی، علیمون، معماری نظامی، دفاعی

لیست موزه ها:

باغ موزه هنر ایرانی: هنر ایرانی، باغ موزه، هنرهای سنتی، صنایع دستی، تاریخ هنر

موزه سینمای ایران: تاریخ سینما، سینمای ایران، فیلم، بازیگران، صنعت سینما

موزه دکتر حسابی: زندگی دکتر حسابی، علم و فناوری، فیزیک، آموزش عالی، شخصیت علمی

موزه موسیقی تهران: موسیقی ایرانی، آلات موسیقی، موسیقی سنتی، موسیقی کلاسیک، موسیقی محلی

موزه زمان: ابزارهای سنجش زمان، ساعت های تاریخی، ساعت سازی، نجوم، تاریخ علم

بنیادفرهنگی امیر کبیر موزه خانه دکتر حبیبی: زندگی دکتر حبیبی، امیر کبیر، تاریخ معاصر، شخصیت سیاسی، خانه تاریخی

موزه هنرهای زیبا: هنرهای زیبا، نقاشی، مجسمه سازی، گرافیک، هنر مدرن

کاخ موزه ملت (کاخ سفید): دوره پهلوی، کاخ سلطنتی، معماری پهلوی، تاریخ معاصر، کاخ سلطنتی

خانه موزه سیمین دانشور و جلال آل احمد: زندگی سیمین دانشور و جلال آل احمد، ادبیات معاصر، نویسندگی، فرهنگ ادبی، خانه تاریخی

موزه اتومبیل های سلطنتی: خودروهای سلطنتی، تاریخ خودرو، ماشین های کلاسیک، وسایل نقلیه تاریخی، دوره پهلوی

خانه نیما یوشیج (تهران): زندگی نیما یوشیج، شعر نو، ادبیات معاصر، خانه تاریخی، فرهنگ ادبی

موزه آشپزخانه سلطنتی: آشپزخانه سلطنتی، لوازم آشپزی، غذاهای سنتی، تاریخ آشپزی، دوره پهلوی

موزه خط و کتابت میرعماد: خط میرعماد، خوشنویسی، تاریخ خوشنویسی، خطاطی، هنر اسلامی

موزه استاد فرشچیان: آثار استاد فرشچیان، نقاشی ایرانی، مینیاتور، هنر سنتی، تاریخ نقاشی

مجموعه فرهنگی تا‌‌‌‌ریخی کاخ سعدآباد: دوره پهلوی، کاخ سلطنتی، معماری پهلوی، تاریخ معاصر، کاخ سلطنتی

موزه استاد حسین بهزاد: آثار استاد حسین بهزاد، نقاشی ایرانی، مینیاتور، هنر سنتی، تاریخ نقاشی

خانه موزه عزت الله انتظامی: زندگی عزت الله انتظامی، سینمای ایران، تئاتر، بازیگری، هنر نمایش

مدل هیدرولیکی بند امیر: بند امیر، مهندسی آب، هیدرولیک، مدل سازی، مهندسی عمران

مدل هیدرولیکی سد کارون 3: سد کارون 3، مهندسی آب، هیدرولیک، مدل سازی، مهندسی عمران

موزه نیروی هوایی: تاریخ نیروی هوایی، هواپیماهای تاریخی، صنعت هوایی، نظامی، تاریخ نظامی

موزه نظامی: تاریخ نظامی ایران، اسلحه های تاریخی، وسایل نظامی، نظامی، تاریخ نظامی

موزه آب: تاریخ آب، فناوری آب، مدیریت منابع آب، آب و محیط زیست، تاریخ علم

کاخ اشرف (موزه ظروف سلطنتی): ظروف سلطنتی، تاریخ ظروف، هنر و صنعت، دوره پهلوی، کاخ سلطنتی

کاخ موزه سبز (کاخ شهوند): دوره پهلوی، کاخ سلطنتی، معماری پهلوی، تاریخ معاصر، کاخ سلطنتی

کاخ شمس (موزه پوشاک سلطنتی): پوشاک سلطنتی، تاریخ مد، لباس های تاریخی، صنعت پوشاک، دوره پهلوی

موزه برادران امیدوار: آثار برادران امیدوار، سینمای ایران، فیلمسازی، هنر سینما، تاریخ سینما

کاخ کوشک احمدشاهی: دوره پهلوی، کاخ سلطنتی، معماری پهلوی، تاریخ معاصر، کاخ سلطنتی

آرت سنتر باغ: هنر معاصر، نمایشگاه هنر، گالری هنری، هنرهای تجسمی، فرهنگ هنری

موزه سلاح های دربار: سلاح های تاریخی، تاریخ نظامی، معماری سنتی، اسلحه سازی، تاریخ جنگ

نگارخانه سعدآباد: نقاشی، مجسمه، هنرهای تجسمی، هنر معاصر، کاخ سعد آباد

موزه کامپیوتر ایران: تاریخ کامپیوتر، کامپیوترهای قدیمی، فناوری اطلاعات، صنعت کامپیوتر، تاریخ علم

موزه مجازی هنر کودک: هنر کودک، هنرهای تجسمی، نقاشی کودک، آموزش هنر، هنر دیجیتال

موزه فرش رسام عرب زاده: فرش های دستباف، فرش ایرانی، صنایع دستی، تاریخ هنر، فرش بافی

موزه موسسه فرهنگی هنری رسام عرب زاده: هنرهای سنتی، صنایع دستی، فرهنگ ایرانی، تاریخ هنر، هنرهای تجسمی

موزه آموزشی سروش: آموزش، تاریخ آموزش، کتاب، مدرسه، فرهنگ آموزشی

موزه رضا عباسی: آثار رضا عباسی، خوشنویسی، نقاشی ایرانی، تاریخ نقاشی، هنر اسلامی

زندان سیاسی شماره 2: تاریخ سیاسی، زندان، زندانیان سیاسی، تاریخ معاصر، حوادث سیاسی

باغ موزه زندان قصر: تاریخ سیاسی، زندان، زندانیان سیاسی، تاریخ معاصر، حوادث سیاسی

موزه ملی کارآفرینان ایرانی: کارآفرینی، تاریخ اقتصاد، صنعت، تجارت، اقتصاد ایران

موزه کودکی ایرانک: تاریخ کودکی، بازی های قدیمی، اسباب بازی، فرهنگ کودکی، آموزش

ساختمان گنجینه اسناد ملی (آرشیو ملی ایران): اسناد ملی، تاریخ ایران، بایگانی، تاریخ نگاری، مدیریت اسناد

باغ موزه ملی کار: تاریخ کار، تاریخ صنعت، کارگران، فناوری، تاریخ اجتماعی

موزه نیروی هوایی ارتش: تاریخ نیروی هوایی، هواپیماهای تاریخی، صنعت هوایی، نظامی، تاریخ نظامی

عمارت ارباب هرمز (موزه گرافیک ایران): گرافیک ایران، تاریخ گرافیک، طراحی، چاپ، هنرهای تجسمی

موزه نسخ خطی کتابخانه ملی: نسخ خطی، کتاب های قدیمی، تاریخ کتاب، خطاطی، تاریخ نگاری

موزه کتاب و میراث مستند ایران: کتاب، تاریخ کتاب، مطالعات کتابداری، بایگانی، فرهنگ مکتوب

پارک موزه آب: تاریخ آب، فناوری آب، مدیریت منابع آب، آب و محیط زیست، تاریخ علم

باغ موزه اب: تاریخ آب، فناوری آب، مدیریت منابع آب، آب و محیط زیست، تاریخ علم

موزه ملی علوم و فناوری: تاریخ علم و فناوری، اختراعات، علم، فناوری، تاریخ علم

موزه سرای شهید آیت الله دکتر بهشتی: زندگی شهید بهشتی، تاریخ انقلاب اسلامی، سیاست، شخصیت سیاسی، خانه تاریخی

نگارخانه نهاوند: نقاشی، مجسمه، هنرهای تجسمی، هنر معاصر، هنرهای زیبا

خانه موزه شهید مطهری: زندگی شهید مطهری، تاریخ انقلاب اسلامی، فلسفه، شخصیت سیاسی، خانه تاریخی

قصر فیروزه (کاخ فرح‌آباد): دوره پهلوی، کاخ سلطنتی، معماری پهلوی، تاریخ معاصر، کاخ سلطنتی

باغ موزه بانک مرکزی ایران: تاریخ بانکداری، اقتصاد ایران، بانکداری، پول، تاریخ اقتصادی

موزه سراسرنمای دفاع مقدس: دفاع مقدس، تاریخ جنگ، تاریخ معاصر، موزه دفاع مقدس، حوادث تاریخی

باغ موزه دفاع مقدس: دفاع مقدس، تاریخ جنگ، تاریخ معاصر، موزه دفاع مقدس، حوادث تاریخی

موزه نقشه تهران: نقشه های تهران، تاریخ تهران، شهرسازی، جغرافیای تهران، تاریخ شهری

خانه موزه استاد لر زاده: زندگی استاد لر زاده، نقاشی، هنر سنتی، تاریخ هنر، خانه تاریخی

موزه عکاس خانه شهر: عکاسی، تاریخ عکاسی، عکس، هنر عکاسی، عکس های تاریخی

موزه آثار شهدا: آثار شهدا، تاریخ جنگ، تاریخ معاصر، موزه دفاع مقدس، حوادث تاریخی

خانه و موزه استاد معین و استاد امیر جاهد: زندگی استاد معین و استاد امیر جاهد، موسیقی سنتی، آواز، موسیقی کلاسیک، خانه تاریخی

موزه صنعت برق ایران: تاریخ صنعت برق، فناوری برق، صنعت برق، مهندسی برق، تاریخ فناوری

مرکز هنر پردیس - سنگسر: هنر معاصر، نمایشگاه هنر، گالری هنری، هنرهای تجسمی، فرهنگ هنری

خانه موزه شهید رجایی: زندگی شهید رجایی، تاریخ انقلاب اسلامی، سیاست، شخصیت سیاسی، خانه تاریخی

باغ موزه نگارستان: هنر سنتی، مینیاتور، نقاشی ایرانی، خطاطی، تاریخ هنر

مجلس قدیم: تاریخ مجلس، سیاست ایران، مجلس شورای ملی، تاریخ سیاسی، معماری تاریخی

موزه هنرهای تجسمی پاسارگاد: هنرهای تجسمی، هنر معاصر، نقاشی، مجسمه سازی، تاریخ هنر

موزه تاریخ مفاخر باغ نگارستان: مفاخر ایران، تاریخ ایران، شخصیت های تاریخی، تاریخ فرهنگی، تاریخ سیاسی

موزه هنرهای ملی: هنرهای ایرانی، تاریخ هنر، نقاشی، مجسمه سازی، هنر سنتی

حمام نواب: حمام سنتی، معماری سنتی، حمام عمومی، فضاهای شهری، تاریخ اجتماعی

خانه موزه شهید مدرس: زندگی شهید مدرس، تاریخ معاصر، سیاست، شخصیت سیاسی، خانه تاریخی

موزه خوشنویسی: خوشنویسی، خطاطی، تاریخ خوشنویسی، هنر اسلامی، هنر سنتی

خانه موزه استاد ابوالحسن صبا: زندگی استاد ابوالحسن صبا، موسیقی سنتی، آواز، موسیقی کلاسیک، خانه تاریخی

موزه نقاشی پشت شیشه: نقاشی پشت شیشه، هنر سنتی، هنرهای تجسمی، نقاشی ایرانی، تاریخ هنر

موزه عمارت کاظمی: معماری سنتی، خانه اعیانی، تاریخ معماری، معماری ایرانی، خانه تاریخی

موزه حمام قبله (حمام خانم): حمام سنتی، معماری سنتی، حمام عمومی، فضاهای شهری، تاریخ اجتماعی

موزه پمپ بنزین دروازه دولت: تاریخ صنعت نفت، تاریخ تهران، صنعت پتروشیمی، فناوری، تاریخ شهری

موزه عروسک و فرهنگ: عروسک، فرهنگ عامه، هنرهای دستی، بازی، تاریخ فرهنگ

خانه موزه شهید دکتر چمران: زندگی شهید چمران، تاریخ انقلاب اسلامی، سیاست، شخصیت سیاسی، خانه تاریخی

موزه و مجتمع فرهنگی 13 آبان: تاریخ انقلاب اسلامی، سیاست، حوادث سیاسی، فرهنگ سیاسی، معماری تاریخی

خانه ابتهاج: زندگی ابتهاج، ادبیات معاصر، شعر، فرهنگ ادبی، خانه تاریخی

موزه جواهرات ملی: جواهرات سلطنتی، تاریخ جواهر، تاریخ ایران، صنایع دستی، گنجینه ملی

موزه بانک ملی ایران: تاریخ بانکداری، اقتصاد ایران، بانکداری، تاریخ اقتصادی، پول

موزه استاد علی اکبر صنعتی: آثار استاد علی اکبر صنعتی، نقاشی، هنر سنتی، تاریخ هنر، تاریخ نقاشی

موزه سکه بانک سپه: سکه های تاریخی، تاریخ پول، numismatics، تاریخ اقتصادی، بانکداری

کاخ برلیان: دوره پهلوی، کاخ سلطنتی، معماری پهلوی، تاریخ معاصر، کاخ سلطنتی

شمس العماره: دوره قاجار، معماری سنتی، معماری ایرانی، خانه تاریخی، معماری سلطنتی

تالار ظروف: ظروف تاریخی، تاریخ ظروف، صنایع دستی، هنر، تاریخ هنر

موزه حوضخانه: معماری سنتی، حوضخانه، معماری ایرانی، خانه تاریخی، فضاهای سنتی

عمارت بادگیر: معماری سنتی، بادگیر، معماری ایرانی، خانه تاریخی، معماری بومی

کاخ موزه گلستان: دوره قاجار، کاخ سلطنتی، معماری قاجار، تاریخ معاصر، معماری سلطنتی

تالار سلام: معماری سنتی، تالار، معماری ایرانی، کاخ سلطنتی، معماری سلطنتی

عمارت چادرخانه و عکسخانه: معماری سنتی، تاریخ عکاسی، معماری ایرانی، خانه تاریخی، معماری سلطنتی

موزه عبرت: تاریخ سیاسی، زندان، زندانیان سیاسی، تاریخ معاصر، حوادث سیاسی

خلوت کریم خانی: معماری سنتی، معماری ایرانی، خانه تاریخی، معماری سلطنتی، کاخ سلطنتی

موزه ارتباطات: تاریخ ارتباطات، تلفن، تلگراف، پست، تاریخ فناوری

موزه مخصوص: تاریخ سیاسی، معماری سنتی، معماری ایرانی، خانه تاریخی، معماری سلطنتی

موزه مردم شناسی (کاخ ابیض): مردم شناسی، فرهنگ عامه، تاریخ اجتماعی، معماری سنتی، کاخ سلطنتی

موزه عكسخانه: تاریخ عکاسی، عکس، هنر عکاسی، عکس های تاریخی، تاریخ فرهنگی

موزه نگارخانه: هنرهای تجسمی، نقاشی، مجسمه سازی، هنر معاصر، تاریخ هنر

موزه گمرک ایران: تاریخ گمرک، تجارت، اقتصاد ایران، تاریخ اقتصادی، تاریخ اجتماعی

موزه کتاب آرایی ملک: کتاب آرایی، هنر سنتی، صنایع دستی، تاریخ هنر، تاریخ کتاب

خانه موزه مهدی اخوان ثالث: زندگی مهدی اخوان ثالث، شعر، ادبیات معاصر، خانه تاریخی، فرهنگ ادبی

موزه سیار خلاقیت کودک و نوجوان: آموزش، کودک، خلاقیت، هنر، آموزش هنر

خانه موزه چمن آرا (بتهوون): زندگی چمن آرا، موسیقی کلاسیک، موسیقی سنتی، خانه تاریخی، فرهنگ ادبی

موزه ملی هنر و ادبیات کودک: هنر کودک، ادبیات کودک، تاریخ فرهنگ کودک، فرهنگ کودک، آموزش

موزه علوم و فناوری: تاریخ علم و فناوری، اختراعات، علم، فناوری، تاریخ علم

موزه فرش ایران: فرش های دستباف، فرش ایرانی، صنایع دستی، تاریخ هنر، فرش بافی

موزه تصاویر معاصر: عکس، تاریخ عکاسی، هنر عکاسی، عکس های تاریخی، تاریخ فرهنگی

موزه خیمه شب بازی: خیمه شب بازی، هنر سنتی، تئاتر سنتی، فرهنگ عامه، تاریخ هنر

موزه ماشین های اداری سفیر: ماشین های اداری، تاریخ فناوری، اداری، تجارت، فناوری

موزه هنرهای معاصر تهران: هنر معاصر، نقاشی، مجسمه، هنرهای تجسمی، تاریخ هنر

موزه هنرهای معاصر فلسطین: هنر معاصر، نقاشی، مجسمه، هنرهای تجسمی، تاریخ هنر

موزه جانور شناسی: جانور شناسی، حیوانات، طبیعت، زیست شناسی، تاریخ طبیعی

موزه تاریخ علوم پزشکی: تاریخ پزشکی، پزشکی، علم پزشکی، تاریخ علم، تاریخ بهداشت

خانه موزه دکتر شریعتی: زندگی دکتر شریعتی، فلسفه، تاریخ معاصر، خانه تاریخی، فرهنگ سیاسی

موزه تمبرهای طلا و نقره ایران: تمبر، تمبرهای طلا و نقره، تاریخ پست، نماد ملی، تاریخ اقتصادی

موزه شهدا: آثار شهدا، تاریخ جنگ، تاریخ معاصر، موزه دفاع مقدس، حوادث تاریخی

خانه موزه دکتر سندوزی: زندگی دکتر سندوزی، تاریخ پزشکی، پزشک، خانه تاریخی، تاریخ علم

خانه موزه هایده چنگیزیان: زندگی هایده چنگیزیان، موسیقی، آواز، خانه تاریخی، فرهنگ هنری

موزه اسباب بازی: اسباب بازی، بازی، تاریخ بازی، کودک، فرهنگ عامه

خانه استاد حسین بهزاد: زندگی استاد حسین بهزاد، نقاشی ایرانی، مینیاتور، هنر سنتی، تاریخ نقاشی

موزه مردم شناسی ارامنه (موزه اسقف اعظم آرداک مانوکیان): مردم شناسی ارمنی، فرهنگ ارمنی، تاریخ ارامنه، تاریخ اجتماعی، فرهنگ اقلیت

موزه علوم و فنون جمهوری اسلامی ایران: تاریخ علم و فناوری، اختراعات، علم، فناوری، تاریخ علم

موزه آبگینه و سفالینه های ایران (خانه قوام السلطنه): آبگینه، سفالینه، تاریخ هنر، صنایع دستی، هنر سنتی

موزه و نمایشگاه هوایی: هواپیماهای تاریخی، تاریخ هوانوردی، صنعت هوافضا، تاریخ نظامی، تاریخ علم

موزه علوم زمین: علوم زمین، زمین شناسی، کانی شناسی، فسیل شناسی، تاریخ طبیعی

موزه آشور ارومیه: تاریخ آشور، تاریخ باستان، باستان شناسی، تمدن آشور، تاریخ ارومیه

موزه برج آزادی (تالار کهن): تاریخ برج آزادی، معماری مدرن، تاریخ معاصر، معماری ایرانی، تاریخ هنر

خانه موزه شهید مهدی پور: زندگی شهید مهدی پور، تاریخ جنگ، تاریخ معاصر، خانه تاریخی، موزه دفاع مقدس

موزه دانشگاه علامه طباطبائی: دانشگاه علامه طباطبائی، تاریخ دانشگاه، تاریخ معاصر، فرهنگ علمی، آموزش عالی

موزه شهیدان اقبالی: شهیدان اقبالی، تاریخ جنگ، تاریخ معاصر، موزه دفاع مقدس، حوادث تاریخی

موزه حیات وحش پردیسان: حیات وحش، حیوانات، طبیعت، زیست شناسی، تاریخ طبیعی

موزه تنوع زیستی: تنوع زیستی، زیست شناسی، طبیعت، حیات وحش، محیط زیست

موزه ملی آب: تاریخ آب، فناوری آب، مدیریت منابع آب، آب و محیط زیست، تاریخ علم

موزه خودروهای تاریخی ایران: خودروهای تاریخی، تاریخ صنعت خودرو، ماشین های کلاسیک، وسایل نقلیه تاریخی، دوره پهلوی

موزه مبل: مبل های تاریخی، تاریخ مبل، صنایع دستی، هنر، تاریخ هنر

موزه شهرداری برج میلاد: تاریخ شهرداری، شهرداری تهران، تاریخ تهران، مدیریت شهری، تاریخ اجتماعی

موزه مشاهیر برج میلاد: مشاهیر ایران، تاریخ ایران، شخصیت های تاریخی، تاریخ فرهنگی، تاریخ سیاسی

موزه حیات وحش و آثار طبیعی هفت چنار: حیات وحش، حیوانات، طبیعت، زیست شناسی، تاریخ طبیعی

خانه تیمورتاش (موزه دانشگاه جنگ): زندگی تیمورتاش، تاریخ معاصر، سیاست، تاریخ نظامی، خانه تاریخی

کاخ تیمورتاش: دوره پهلوی، کاخ سلطنتی، معماری پهلوی، تاریخ معاصر، کاخ سلطنتی

خانه موزه شهیدان کربلایی: زندگی شهیدان کربلایی، تاریخ جنگ، تاریخ معاصر، خانه تاریخی، موزه دفاع مقدس

نمایشگاه موشکی نیروی هوا فضا سپاه: موشک، نیروی هوافضا سپاه، صنعت دفاعی، تاریخ نظامی، تاریخ فناوری

موزه عبدالعظیم حسنی: زندگی عبدالعظیم حسنی، تاریخ معاصر، سیاست، شخصیت سیاسی، خانه تاریخی

موزه‌ها و مرکز اسناد صنعت نفت: تاریخ صنعت نفت، نفت، صنعت پتروشیمی، اقتصاد ایران، تاریخ اقتصادی

موزه عمارت انیس الدوله: معماری سنتی، خانه اعیانی، تاریخ معماری، معماری ایرانی، خانه تاریخی

موزه شهید قدمی: زندگی شهید قدمی، تاریخ جنگ، تاریخ معاصر، موزه دفاع مقدس، حوادث تاریخی

موزه مفاخر: مفاخر ایران، تاریخ ایران، شخصیت های تاریخی، تاریخ فرهنگی، تاریخ سیاسی

موزه دخانیات ایران: تاریخ دخانیات، صنعت دخانیات، تاریخ اقتصادی، تجارت، تاریخ اجتماعی

موزه تاریخ روانپزشکی روزبه: تاریخ روانپزشکی، روانپزشکی، پزشکی، تاریخ پزشکی، تاریخ علم

لیست رستوران ها:

جیگرکی امیر: جیگر، کباب، غذاهای سنتی، غذاهای ایرانی، رستوران سنتی

سفره خانه سنتی زیر بازارچه: غذاهای سنتی، رستوران سنتی، فضای سنتی، محیط سنتی، غذاهای ایرانی

کباب بناب آذربایجان: کباب بناب، غذاهای آذری، کباب، غذاهای ایرانی، رستوران سنتی

رستوران میلاد: غذاهای ایرانی، رستوران، غذاهای سنتی، غذاهای مدرن، پذیرایی

رستوران و تهیه غذای پارسی: غذاهای ایرانی، غذاهای سنتی، پذیرایی، تهیه غذا، غذاهای پارسی

کافه رستوران سورینو: کافه، رستوران، غذاهای فرنگی، نوشیدنی، غذاهای بین المللی

رستوران حاج محسن: غذاهای ایرانی، رستوران، غذاهای سنتی، غذاهای محلی، پذیرایی

رستوران ترک دنر پیروزی: دنر کباب، غذاهای ترکی، غذاهای فرنگی، غذاهای بین المللی، فست فود

رستوران پرواز: غذاهای ایرانی، رستوران، غذاهای سنتی، غذاهای مدرن، پذیرایی

حلیم و آش فروشی حاج علی و پسران: حلیم، آش، غذاهای سنتی، غذاهای ایرانی، رستوران سنتی

رستوران شبستری: غذاهای ایرانی، رستوران، غذاهای سنتی، غذاهای محلی، پذیرایی

کبابخانه تشریفات گلپایگانی: کباب، تشریفات، کباب گلپایگانی، غذاهای ایرانی، رستوران سنتی

سفره خانه سنتی خشت بهشت: غذاهای سنتی، رستوران سنتی، فضای سنتی، محیط سنتی، غذاهای ایرانی

رستوران محمد مهدی: غذاهای ایرانی، رستوران، غذاهای سنتی، غذاهای مدرن، پذیرایی

رستوران مهر: غذاهای ایرانی، رستوران، غذاهای سنتی، غذا