مکان های تاریخی:

آرامستان تاریخی مسیحیان دولاب: گورستان لهستانی ها، معماری ارمنی، سنگ قبرهای قدیمی، دوره قاجار

عمارت تاریخی کلاه فرنگی عشرت آباد: معماری قاجاری، باغ ایرانی، محل اقامت تابستانی، کاشی کاری هفت رنگ

کودکستان تاریخی برسابه: معماری پهلوی اول، آموزش و پرورش نوین، فضای آموزشی اولیه، سبک ساختمانی دهه 1300

عمارت سرهنگ ایرج (خانه تاریخی پامنار): خانه مسکونی قاجاری، تزئینات گچبری، حیاط مرکزی، معماری سنتی

برجک تاریخی زندان قصر: بازمانده زندان قاجاری، معماری نظامی، دیده بانی، محل نگهداری زندانیان سیاسی

عمارت امین السلطان (خانه تاریخی اتحادیه): خانه مسکونی قاجاری، محل زندگی صدراعظم، معماری اندرونی و بیرونی، تزئینات چوبی

بازارچه تاریخی عودلاجان: بافت قدیمی تهران، راسته های تجاری، معماری سنتی بازار، حمام های قدیمی

عمارت تاریخی امام جمعه: خانه روحانیون، معماری دوره قاجار، حیاط بزرگ، فضای مذهبی

مدرسه تاریخی دارالفنون: نخستین دانشگاه مدرن، آموزش علوم جدید، معماری نئوکلاسیک، دوره ناصری

خانه تاریخی ملک: خانه مسکونی قاجاری، معماری اعیانی، مجموعه موزه و کتابخانه، وقف فرهنگی

عمارت تاریخی کوچه هفت تن: خانه مسکونی دوره قاجار، بافت تاریخی عودلاجان، معماری مسکونی سنتی

سرای باستانی: بافت قدیمی شهرری، معماری خشتی، کاروانسرای قدیمی، فضای تجاری

عمارت و باغ تاریخی اعلم السلطنه: باغ ایرانی قاجاری، عمارت مسکونی، معماری تلفیقی، فضای سبز

خانه تاریخی مستوفی الممالک: خانه سیاستمدار، معماری قاجاری، محل رفت و آمد رجال، تزئینات خاص

خانه باستان شناسان ایران: محل گردهمایی باستان شناسان، معماری مدرن، مرکز مطالعات، کتابخانه تخصصی

باغ عمارت تاریخی معیرالممالک کیهانی: باغ قاجاری، عمارت مسکونی، فضای سبز، معماری با شکوه

بازارچه تاریخی نایب آقا: بازارچه محلی قدیمی، معماری سنتی، فضای تجاری، بافت تاریخی

آتشکده تاریخی به سمت کوه راگا: بقایای آتشکده زرتشتی، دوره ساسانی، آیین های مذهبی، معماری سنگی

قلعه باستانی عظیم آباد: قلعه نظامی، دوره باستانی، معماری دفاعی، بافت تاریخی

خانه تاریخی علامه کرباسچیان: خانه عالم دینی، معماری قاجاری، محل درس و بحث، بافت تاریخی

عمارت تاریخی خسروشاهی: خانه مسکونی قاجاری، معماری اعیانی، تزئینات گچبری، حیاط مرکزی

حمام تاریخی کن: حمام عمومی قدیمی، دوره قاجار، معماری سنتی حمام، بافت تاریخی

پل تاریخی کن: پل قدیمی، دوره قاجار، معماری سنگی، مسیر تردد

مجموعه فرهنگی تاریخی کاخ نیاوران: کاخ سلطنتی پهلوی، مجموعه باغ و کاخ ها، معماری مدرن، موزه های متعدد

موزه ملی ایران باستان: دوره پیش از اسلام، آثار باستانی، تمدن ایران، موزه باستان شناسی

باغ و عمارت فخر الدوله: باغ ایرانی قاجاری، عمارت مسکونی، معماری تلفیقی، فضای سبز

خانه مداحان اهل بیت (ع): محل تجمع مداحان، معماری مذهبی، فضای معنوی، محل برگزاری مراسم

دفتر قدیمی مجله صبح امروز و ماهنامه دانشمند: محل انتشار نشریات، معماری اداری، بافت قدیمی مطبوعات، دفتر تحریریه

خانه فراغت (عمارت دبیرالملک): خانه مسکونی قاجاری، معماری اعیانی، تزئینات گچبری، حیاط مرکزی

خانه قوام الدوله: خانه مسکونی قاجاری، معماری اعیانی، محل زندگی رجال، تزئینات خاص

خانه همسایه: خانه مسکونی قاجاری، معماری ساده، بافت محلی، فضای صمیمی

خانه اردیبهشت‌ عودلاجان: خانه مسکونی قاجاری، بافت تاریخی، معماری اندرونی و بیرونی، تزئینات چوبی

خانه موتمن الاطبا: خانه طبیب، معماری دوره قاجار، فضای پزشکی، تزئینات خاص

خانه لشگر نویس: خانه اداری، معماری دوره قاجار، بافت اداری نظامی، فضای ثبت اسناد

خانه موزه بازار (عمارت سلطان بیگم): خانه مسکونی قاجاری، بافت بازار، معماری تجاری مسکونی، موزه محلی

عمارت سرهنگ بهرامی: خانه مسکونی قاجاری، معماری اعیانی، تزئینات گچبری، حیاط مرکزی

عمارت کوشک: باغ ایرانی، عمارت مسکونی، معماری قاجاری، فضای تفریحی

خانه خسرو افشار - ستاد سمن های شهر تهران: خانه مسکونی، محل استقرار سازمان های مردم نهاد، معماری اداری، فضای فعالیت مدنی

عمارت شقاقی - کوشک مصری: خانه مسکونی، معماری تلفیقی، تزئینات مصری، بافت خاص

آتشکده زرتشتیان آدریان: آتشکده زرتشتی، محل عبادت، آیین های مذهبی، معماری سنگی

موزه خودروهای تاریخی ایران: مجموعه خودروهای قدیمی، دوره های تاریخی، موزه خودرو، صنعت خودرو سازی

کاخ خرم (کاخ سنگی): کاخ سلطنتی، معماری خاص، مصالح سنگی، دوره پهلوی

خانه پروفسور یحیی عدل: خانه دانشمند، معماری مدرن، محل زندگی علمی، بافت دانشگاهی

برجک قلعه شمس آباد: برج دیده بانی، بافت نظامی، دوره قاجار، معماری خشتی

آسیاب آبی یوسف آباد: آسیاب قدیمی، دوره قاجار، معماری آبی، بافت روستایی

حمام انصاری: حمام عمومی قدیمی، دوره قاجار، معماری سنتی حمام، بافت تاریخی

برج تاریخی طغرل: برج آجری، دوره سلجوقی، معماری مقبره ای، دیده بانی

قلعه تاریخی کاسنی: قلعه نظامی، دوره قاجار، معماری دفاعی، بافت تاریخی

باغ ظهیرالدوله: باغ ایرانی قاجاری، مقبره مشاهیر، فضای سبز، معماری تلفیقی

باروی ری: دیوار دفاعی شهرری، دوره سلجوقی، معماری خشتی، بافت تاریخی

سنگ نگاره فتحعلی شاه شهرری: سنگ نگاره قاجاری، تصویر پادشاه، هنر حجاری، تاریخ سلطنت

ارگ سلجوقی ری: ارگ نظامی، دوره سلجوقی، معماری دفاعی، بافت تاریخی

دژ رشکان: دژ نظامی، دوره باستانی، معماری دفاعی، بافت تاریخی

قلعه ظهیرآباد: قلعه نظامی، دوره قاجار، معماری دفاعی، بافت تاریخی

کاروانسرای صفوی (عباسی): کاروانسرا قدیمی، دوره صفوی، معماری کاروانسرا، بافت تجاری

کاروانسرای دوقلو قاجاری: کاروانسرا قدیمی، دوره قاجار، معماری کاروانسرا، بافت تجاری

ساعت آفتابی: ابزار سنجش زمان، دوره قاجار، علم نجوم، بافت علمی

قلعه گبری شهر ری: قلعه باستانی، دوره پیش از اسلام، معماری دفاعی، بافت تاریخی

محله هفت دستگاه: محله قدیمی، بافت تاریخی، معماری مسکونی، بافت محلی

برج نقاره خانه (برج یزید ری): برج آجری، دوره سلجوقی، کاربرد مذهبی، معماری نظامی

برج اینانج: برج آجری، دوره سلجوقی، معماری مقبره ای، بافت تاریخی

قلعه علیمون: قلعه نظامی، دوره قاجار، معماری دفاعی، بافت تاریخی

موزه ها:

باغ موزه هنر ایرانی: هنر ایرانی، آثار هنری، باغ ایرانی، فضای هنری

موزه سینمای ایران: تاریخ سینمای ایران، آثار سینمایی، تجهیزات فیلمسازی، موزه هنری

موزه دکتر حسابی: زندگی دکتر حسابی، آثار علمی، دستاوردهای فیزیک، موزه علم

موزه موسیقی تهران: تاریخ موسیقی ایران، سازهای سنتی، آثار موسیقی دانان، موزه هنری

موزه زمان: ابزارهای سنجش زمان، ساعت های قدیمی، تاریخ زمان، موزه تخصصی

بنیاد فرهنگی امیر کبیر موزه خانه دکتر حبیبی: آثار دکتر حبیبی، موزه شخصی، فعالیت های فرهنگی، موزه شخصیت ها

موزه هنرهای زیبا: آثار هنری، هنرهای تجسمی، نقاشی و مجسمه، موزه هنری

کاخ موزه ملت (کاخ سفید): کاخ سلطنتی، موزه تاریخی، محل اقامت شاه، معماری سلطنتی

خانه موزه سیمین دانشور و جلال آل احمد: زندگی نویسندگان، آثار ادبی، محل زندگی مشاهیر، موزه شخصیت ها

موزه اتومبیل های سلطنتی: خودروهای سلطنتی، تاریخ خودرو سازی، مجموعه خودرو، موزه خودرو

خانه نیما یوشیج (تهران): زندگی نیما یوشیج، آثار ادبی، محل زندگی شاعر، موزه ادبی

موزه آشپزخانه سلطنتی: ظروف آشپزخانه سلطنتی، تاریخ آشپزی، موزه ظروف، فرهنگ غذایی

موزه خط و کتابت میرعماد: آثار میرعماد، خوشنویسی ایرانی، تاریخ کتابت، موزه هنری

موزه استاد فرشچیان: آثار استاد فرشچیان، نگارگری ایرانی، هنر مینیاتور، موزه هنری

مجموعه فرهنگی تا‌‌‌‌ریخی کاخ سعدآباد: مجموعه کاخ ها و موزه ها، تاریخ معاصر، موزه های متنوع، معماری سلطنتی

موزه استاد حسین بهزاد: آثار استاد بهزاد، نقاشی ایرانی، هنر نگارگری، موزه هنری

خانه موزه عزت الله انتظامی: زندگی عزت الله انتظامی، آثار سینمایی، محل زندگی هنرمند، موزه هنری

مدل هیدرولیکی بند امیر: ماکت بند امیر، مهندسی سازه، آب شناسی، موزه فنی

مدل هیدرولیکی سد کارون 3: ماکت سد کارون 3، مهندسی سازه، آب شناسی، موزه فنی

موزه نیروی هوایی: تاریخ نیروی هوایی، تجهیزات نظامی، هواپیما و هلیکوپتر، موزه نظامی

موزه نظامی: تاریخ نظامی ایران، تجهیزات جنگی، سلاح های قدیمی، موزه نظامی

موزه آب: تاریخ آب ایران، تکنولوژی آب، ابزار آلات آبیاری، موزه فنی

کاخ اشرف (موزه ظروف سلطنتی): ظروف سلطنتی، تاریخ ظروف، موزه کاخ، فرهنگ اشرافی

کاخ موزه سبز (کاخ شهوند): کاخ سلطنتی، موزه تاریخی، معماری سلطنتی، موزه کاخ

کاخ شمس (موزه پوشاک سلطنتی): لباس های سلطنتی، تاریخ مد، موزه پوشاک، فرهنگ اشرافی

موزه برادران امیدوار: سفرنامه های برادران امیدوار، موزه مردم شناسی، فرهنگ سفر، موزه شخصی

کاخ کوشک احمدشاهی: کاخ سلطنتی، موزه تاریخی، معماری سلطنتی، موزه کاخ

آرت سنتر باغ: آثار هنری معاصر، نمایشگاه هنری، گالری هنری، فضای هنری

موزه سلاح های دربار: سلاح های سلطنتی، تاریخ سلاح، موزه نظامی، فرهنگ نظامی

نگارخانه سعدآباد: نمایشگاه هنری، آثار هنری معاصر، گالری نقاشی، فضای هنری

موزه کامپیوتر ایران: تاریخ کامپیوتر، تجهیزات رایانه، موزه فناوری، موزه علمی

موزه مجازی هنر کودک: آثار هنری کودکان، آموزش هنر، موزه مجازی، موزه هنری

موزه فرش رسام عرب زاده: فرش ایرانی، هنر فرش بافی، موزه فرش، موزه هنری

موزه موسسه فرهنگی هنری رسام عرب زاده: هنر ایرانی، آثار هنری، فعالیت های فرهنگی، موزه فرهنگی

موزه آموزشی سروش: آموزش و پرورش، تجهیزات آموزشی، موزه آموزشی، موزه مدرسه

موزه رضا عباسی: آثار رضا عباسی، هنر ایرانی، نقاشی و خوشنویسی، موزه هنری

زندان سیاسی شماره 2: تاریخ زندان، زندانیان سیاسی، موزه سیاسی، محل عبرت

باغ موزه زندان قصر: تاریخ زندان، زندانیان سیاسی، موزه سیاسی، فضای بازسازی

موزه ملی کارآفرینان ایرانی: تاریخ کارآفرینی، کارآفرینان موفق، موزه اقتصادی، موزه کسب و کار

موزه کودکی ایرانک: تاریخ کودکی، بازی های کودکانه، موزه کودک، موزه آموزشی

ساختمان گنجینه اسناد ملی (آرشیو ملی ایران): اسناد تاریخی، آرشیو ملی، موزه اسناد، موزه تاریخ

باغ موزه ملی کار: تاریخ کار، ابزار کار، موزه صنعت، موزه کارگری

موزه نیروی هوایی ارتش: تاریخ نیروی هوایی، تجهیزات نظامی، هواپیما و هلیکوپتر، موزه نظامی

عمارت ارباب هرمز (موزه گرافیک ایران): تاریخ گرافیک، آثار گرافیکی، موزه هنری، موزه طراحی

موزه نسخ خطی کتابخانه ملی: نسخ خطی قدیمی، تاریخ کتابت، موزه کتاب، موزه تخصصی

موزه کتاب و میراث مستند ایران: تاریخ کتاب، موزه مستند، موزه کتابخانه، میراث فرهنگی

پارک موزه آب: تاریخ آب، تکنولوژی آب، فضای باز موزه، موزه فنی

باغ موزه اب: تاریخ آب، تکنولوژی آب، فضای باز موزه، موزه فنی

موزه ملی علوم و فناوری: تاریخ علم، دستاوردهای علمی، موزه علم، موزه فناوری

موزه سرای شهید آیت الله دکتر بهشتی: زندگی شهید بهشتی، آثار فکری، موزه شخصیت ها، موزه مذهبی

نگارخانه نهاوند: نمایشگاه هنری، آثار هنری معاصر، گالری نقاشی، فضای هنری

خانه موزه شهید مطهری: زندگی شهید مطهری، آثار فکری، موزه شخصیت ها، موزه مذهبی

قصر فیروزه (کاخ فرح‌آباد): کاخ سلطنتی، موزه تاریخی، معماری سلطنتی، موزه کاخ

باغ موزه بانک مرکزی ایران: تاریخ بانک، سکه های قدیمی، موزه بانک، موزه اقتصادی

موزه سراسرنمای دفاع مقدس: تاریخ جنگ، موزه دفاع مقدس، فضای جنگ، موزه نظامی

باغ موزه دفاع مقدس: تاریخ جنگ، موزه دفاع مقدس، فضای جنگ، موزه نظامی

موزه نقشه تهران: تاریخ نقشه کشی، نقشه های قدیمی، موزه نقشه، موزه تخصصی

خانه موزه استاد لر زاده: آثار استاد لر زاده، هنر معماری، موزه معماری، موزه هنری

موزه عکاس خانه شهر: تاریخ عکاسی، عکس های قدیمی، موزه عکس، موزه تخصصی

موزه آثار شهدا: آثار شهدا، موزه دفاع مقدس، موزه شهدا، موزه مذهبی

خانه و موزه استاد معین و استاد امیر جاهد: زندگی استادان معین و جاهد، موزه شخصیت ها، موزه ادبی، موزه موسیقی

موزه صنعت برق ایران: تاریخ برق، تجهیزات برق، موزه صنعت، موزه فنی

مرکز هنر پردیس - سنگسر: مرکز فرهنگی هنری، آثار هنری، فضای هنری، گالری هنری

خانه موزه شهید رجایی: زندگی شهید رجایی، آثار سیاسی، موزه شخصیت ها، موزه سیاسی

باغ موزه نگارستان: تاریخ نگارستان، موزه هنر، فضای فرهنگی، معماری تاریخی

مجلس قدیم: تاریخ مجلس، موزه پارلمان، فضای سیاسی، موزه تاریخ

موزه هنرهای تجسمی پاسارگاد: آثار هنرهای تجسمی، موزه هنری، فضای هنری، گالری هنری

موزه تاریخ مفاخر باغ نگارستان: زندگی مفاخر، موزه شخصیت ها، موزه تاریخی، موزه فرهنگی

موزه هنرهای ملی: هنرهای ملی ایران، موزه هنری، آثار هنری، موزه فرهنگی

حمام نواب: حمام تاریخی، معماری حمام، موزه حمام، فرهنگ حمام

خانه موزه شهید مدرس: زندگی شهید مدرس، موزه شخصیت ها، موزه سیاسی، موزه مذهبی

موزه خوشنویسی: آثار خوشنویسی، هنر خوشنویسی، موزه هنری، موزه تخصصی

خانه موزه استاد ابوالحسن صبا: زندگی استاد صبا، موسیقی ایرانی، موزه موسیقی، موزه هنری

موزه نقاشی پشت شیشه: نقاشی پشت شیشه، هنر نقاشی، موزه هنری، موزه تخصصی

موزه عمارت کاظمی: معماری قاجاری، موزه معماری، موزه تاریخی، بافت قدیمی

موزه حمام قبله (حمام خانم): حمام تاریخی، معماری حمام، موزه حمام، فرهنگ حمام

موزه پمپ بنزین دروازه دولت: پمپ بنزین قدیمی، تاریخ صنعت، موزه صنعت، موزه تخصصی

موزه عروسک و فرهنگ: عروسک های قدیمی، فرهنگ عروسک، موزه کودک، موزه فرهنگی

خانه موزه شهید دکتر چمران: زندگی شهید چمران، موزه شخصیت ها، موزه علمی، موزه مذهبی

موزه و مجتمع فرهنگی 13 آبان: وقایع 13 آبان، موزه سیاسی، موزه تاریخی، موزه فرهنگی

خانه ابتهاج: زندگی ابتهاج، موزه شخصیت ها، موزه ادبی، موزه هنری

موزه جواهرات ملی: جواهرات سلطنتی، موزه جواهرات، موزه تخصصی، موزه خزانه

موزه بانک ملی ایران: تاریخ بانک ملی، اسناد بانکی، موزه بانک، موزه اقتصادی

موزه استاد علی اکبر صنعتی: آثار استاد صنعتی، هنر مجسمه سازی، موزه هنری، موزه مجسمه

موزه سکه بانک سپه: سکه های قدیمی، موزه سکه، موزه بانک، موزه تخصصی

کاخ برلیان: کاخ سلطنتی، موزه تاریخی، معماری سلطنتی، موزه کاخ

شمس العماره: معماری قاجاری، موزه معماری، موزه تاریخی، بافت قدیمی

تالار ظروف: ظروف سلطنتی، موزه ظروف، موزه تاریخی، فرهنگ اشرافی

موزه حوضخانه: معماری حوضخانه، موزه معماری، موزه تاریخی، بافت قدیمی

عمارت بادگیر: معماری بادگیر، موزه معماری، موزه تاریخی، بافت قدیمی

کاخ موزه گلستان: مجموعه کاخ ها، موزه تاریخی، معماری سلطنتی، موزه کاخ

تالار سلام: تالار سلطنتی، موزه تاریخی، معماری سلطنتی، موزه کاخ

عمارت چادرخانه و عکسخانه: تاریخ چادر و عکس، موزه تاریخی، موزه فرهنگ، موزه تخصصی

موزه عبرت: تاریخ زندان، شکنجه های ساواک، موزه سیاسی، محل عبرت

خلوت کریم خانی: بنای تاریخی، معماری قاجاری، موزه تاریخی، بافت قدیمی

موزه ارتباطات: تاریخ ارتباطات، تجهیزات ارتباطی، موزه فنی، موزه تخصصی

موزه مخصوص: مجموعه آثار هنری، موزه هنری، موزه شخصی، موزه تخصصی

موزه مردم شناسی (کاخ ابیض): فرهنگ مردم، موزه مردم شناسی، آداب و رسوم، موزه فرهنگی

موزه عكسخانه: تاریخ عکاسی، عکس های قدیمی، موزه عکس، موزه تخصصی

موزه نگارخانه: نمایشگاه هنری، گالری نقاشی، موزه هنری، فضای هنری

موزه گمرک ایران: تاریخ گمرک، موزه اقتصادی، موزه تخصصی، موزه دولتی

موزه کتاب آرایی ملک: تاریخ کتاب آرایی، موزه کتاب، موزه هنری، موزه تخصصی

خانه موزه مهدی اخوان ثالث: زندگی اخوان ثالث، آثار ادبی، موزه ادبی، موزه شخصیت ها

موزه سیار خلاقیت کودک و نوجوان: موزه سیار، خلاقیت کودکان، موزه کودک، موزه آموزشی

خانه موزه چمن آرا (بتهوون): زندگی چمن آرا، موزه موسیقی، موزه شخصیت ها، موزه هنری

موزه ملی هنر و ادبیات کودک: هنر کودک، ادبیات کودک، موزه کودک، موزه هنری

موزه علوم و فناوری: تاریخ علم، دستاوردهای علمی، موزه علم، موزه فناوری

موزه فرش ایران: تاریخ فرش، هنر فرش بافی، موزه فرش، موزه هنری

موزه تصاویر معاصر: آثار هنری معاصر، موزه هنری، هنر مدرن، گالری هنری

موزه خیمه شب بازی: نمایش عروسکی، موزه نمایش، موزه فرهنگی، هنر سنتی

موزه ماشین های اداری سفیر: ماشین های اداری قدیمی، موزه صنعت، موزه تخصصی، موزه فناوری

موزه هنرهای معاصر تهران: هنر معاصر، موزه هنری، هنر مدرن، گالری هنری

موزه هنرهای معاصر فلسطین: هنر معاصر فلسطین، موزه هنری، هنر سیاسی، گالری هنری

موزه جانور شناسی: جانوران مختلف، موزه حیات وحش، موزه علمی، موزه طبیعت

موزه تاریخ علوم پزشکی: تاریخ پزشکی، موزه پزشکی، موزه علمی، موزه تخصصی

خانه موزه دکتر شریعتی: زندگی دکتر شریعتی، آثار فکری، موزه شخصیت ها، موزه مذهبی

موزه تمبرهای طلا و نقره ایران: تمبرهای قدیمی، موزه تمبر، موزه تخصصی، موزه پستی

موزه شهدا: آثار شهدا، موزه دفاع مقدس، موزه شهدا، موزه مذهبی

خانه موزه دکتر سندوزی: زندگی دکتر سندوزی، موزه شخصیت ها، موزه علمی، موزه تخصصی

خانه موزه هایده چنگیزیان: زندگی هایده چنگیزیان، موزه شخصیت ها، موزه هنری، موزه تخصصی

موزه اسباب بازی: اسباب بازی های قدیمی، موزه کودک، موزه تخصصی، فرهنگ اسباب بازی

خانه استاد حسین بهزاد: آثار استاد بهزاد، نقاشی ایرانی، هنر نگارگری، موزه هنری

موزه مردم شناسی ارامنه (موزه اسقف اعظم آرداک مانوکیان): فرهنگ ارامنه، موزه مردم شناسی، موزه مذهبی، موزه فرهنگی

موزه علوم و فنون جمهوری اسلامی ایران: دستاوردهای علمی، موزه علم، موزه فناوری، موزه تخصصی

موزه آبگینه و سفالینه های ایران (خانه قوام السلطنه): شیشه و سفال، موزه آبگینه، موزه سفال، موزه هنری

موزه و نمایشگاه هوایی: تاریخ هوانوردی، هواپیما و هلیکوپتر، موزه هوانوردی، موزه نظامی

موزه علوم زمین: تاریخ زمین، سنگ های قیمتی، موزه زمین شناسی، موزه علمی

موزه آشور ارومیه: آثار باستانی آشور، موزه باستان شناسی، موزه تاریخی، موزه تخصصی

موزه برج آزادی (تالار کهن): تاریخ برج آزادی، موزه فرهنگی، موزه تاریخی، نماد ملی

خانه موزه شهید مهدی پور: زندگی شهید مهدی پور، موزه شخصیت ها، موزه مذهبی، موزه دفاع مقدس

موزه دانشگاه علامه طباطبائی: موزه دانشگاهی، تاریخ دانشگاه، موزه علمی، موزه تخصصی

موزه شهیدان اقبالی: زندگی شهیدان اقبالی، موزه شهدا، موزه مذهبی، موزه دفاع مقدس

موزه حیات وحش پردیسان: حیوانات تاکسیدرمی شده، موزه حیات وحش، موزه علمی، موزه طبیعت

موزه تنوع زیستی: تنوع زیستی، موزه طبیعت، موزه علمی، موزه تخصصی

موزه ملی آب: تاریخ آب ایران، موزه آب، موزه فنی، موزه تخصصی

موزه خودروهای تاریخی ایران: مجموعه خودروهای قدیمی، دوره های تاریخی، موزه خودرو، صنعت خودرو سازی

موزه مبل: تاریخ مبل، موزه مبلمان، موزه هنری، موزه تخصصی

موزه شهرداری برج میلاد: تاریخ شهرداری، موزه شهری، موزه تخصصی، موزه دولتی

موزه مشاهیر برج میلاد: زندگی مشاهیر، موزه شخصیت ها، موزه تاریخی، موزه فرهنگی

موزه حیات وحش و آثار طبیعی هفت چنار: حیات وحش محلی، موزه حیات وحش، موزه طبیعت، موزه علمی

خانه تیمورتاش (موزه دانشگاه جنگ): تاریخ نظامی، موزه نظامی، موزه دانشگاهی، موزه تخصصی

کاخ تیمورتاش: کاخ سلطنتی، موزه تاریخی، معماری سلطنتی، موزه کاخ

خانه موزه شهیدان کربلایی: زندگی شهیدان کربلایی، موزه شهدا، موزه مذهبی، موزه دفاع مقدس

نمایشگاه موشکی نیروی هوا فضا سپاه: تجهیزات موشکی، موزه نظامی، موزه دفاع مقدس، موزه هوافضا

موزه عبدالعظیم حسنی: آثار مذهبی، موزه مذهبی، موزه تاریخی، موزه زیارتی

موزه‌ها و مرکز اسناد صنعت نفت: تاریخ نفت ایران، موزه صنعت، موزه تخصصی، موزه اقتصادی

موزه عمارت انیس الدوله: معماری قاجاری، موزه معماری، موزه تاریخی، بافت قدیمی

موزه شهید قدمی: زندگی شهید قدمی، موزه شهدا، موزه مذهبی، موزه دفاع مقدس

موزه مفاخر: زندگی مفاخر، موزه شخصیت ها، موزه تاریخی، موزه فرهنگی

موزه دخانیات ایران: تاریخ دخانیات، موزه صنعت، موزه تخصصی، موزه اقتصادی

موزه تاریخ روانپزشکی روزبه: تاریخ روانپزشکی، موزه پزشکی، موزه تخصصی، موزه علمی